width: 13
height: 8
tiles: \
- - - - - - - - - - - - - \
3 3 - - - - - - - - - - - \
- - - - - - - - - - - - - \
- - - - - - 3 3 - - - - - \
- - - - - - - - - - - - - \
- - - - - - - - - - - - - \
0 0 0 0 0 0 0 0 0 0 0 0 0 \
2 2 2 2 2 2 2 2 2 2 2 2 2
enemies: ram 50 300 5 \
         ram 300 50 5
entities: tree 300 350
