17 10
475 350
0 0 0 0 0 0 0 1 2 1 1 1 1 1 6 1 1
1 1 1 1 1 1 1 1 1 1 1 1 1 1 6 1 1
2 2 2 2 2 2 2 2 1 1 1 1 1 1 6 1 1
0 3 0 0 0 0 3 1 1 1 2 2 2 2 2 2 0
0 3 1 0 0 0 3 1 1 1 3 3 2 2 2 2 0
2 2 2 1 0 0 3 1 1 1 3 0 0 0 7 2 0
4 4 4 1 0 0 0 1 1 1 3 0 0 0 7 0 0
2 4 2 2 0 0 0 0 2 2 2 0 0 0 7 7 0
0 0 0 0 0 0 0 1 1 1 1 0 0 0 0 0 3
0 3 3 3 3 3 3 3 3 0 0 0 3 3 3 3 3
